{
  "name": "Mega Collaborative Challenge",
  "tiles": [
    "####################################################",
    "#....#.........#............#............#.....#...#",
    "#....#......................#............#.....#...#",
    "#....###.......#............#............#.....#...#",
    "#......#.......#............#............#.....#...#",
    "#......###.#####............#............###.###.###",
    "#............#.#............#......................#",
    "#............#.#............#......................#",
    "#............#.#............#......................#",
    "#............#.#............#......................#",
    "#####.#######.#.########...#.##########.############",
    "#............#.#...........#...........#...........#",
    "#............#.#...........#...........#...........#",
    "#............#.#...........#...........#...........#",
    "#............#.#...........#...........#...........#",
    "#............#.#...........#...........#...........#",
    "######.######.#.#########...###########.############",
    "#............#.#...........#...........#..OOOOOOO..#",
    "#............#.#...........#...........#..OOOOOOO..#",
    "#............#.#...OOOOO...#...........#..OOOOOOO..#",
    "#............#.#...O...O...#...........#..OOOOOOO..#",
    "#............#.#...O.#.O...#...........#..OOOOOOO..#",
    "######.######.##...O...O...#...........#..OOOOOOO..#",
    "#............#.#...OOOOO...#...........#..OOOOOOO..#",
    "#............#.#...........#...........#..OOOOOOO..#",
    "#............#.#...........#...........#..OOOOOOO..#",
    "#............#.#...........#...........#...........#",
    "#............#.#...........#...........#...........#",
    "######.######.#.###########.###########.###########",
    "#............#.#...........#...........#...........#",
    "#............#.#...........#...........#...........#",
    "#............#.#...........#...........#...........#",
    "#............#.#...........#...........#...........#",
    "#............#.#...........#...........#...........#",
    "######.######.#.###########.###########.###########",
    "#............#.#...........#...........#...........#",
    "#............#.#...........#...........#...........#",
    "#............#.#...........#...........#...........#",
    "#............#.#...........#.......................#",
    "#............#.#...........#...........#...........#",
    "######.######.#.############.###########.###########",
    "#............#.#............#......................#",
    "#............#.#............#......................#",
    "#............#.#............#......................#",
    "#............#.#............#......................#",
    "#....#####.#####............#............#########.#",
    "#....#.........#............#............#.....#...#",
    "#....#.........#............#............#.....#...#",
    "#....#.........#............#............#.....#...#",
    "#....#.........#............#..................#...#",
    "####################################################"
  ],
  "characters": [
    [1, 1],
    [48, 1],
    [1, 48],
    [48, 48]
  ],
  "blocks": [
    [5, 5, 1, 1],
    [44, 5, 1, 1],
    [5, 44, 1, 1],
    [44, 44, 1, 1],
    [24, 20, 1, 1],
    [25, 20, 1, 1],
    [24, 24, 1, 1],
    [25, 24, 1, 1]
  ],
  "keys": [
    [3, 3, "R"],
    [46, 3, "G"],
    [3, 46, "B"],
    [46, 46, "Y"]
  ],
  "doors": [
    [24, 10, "R"],
    [25, 10, "G"],
    [24, 40, "B"],
    [25, 40, "Y"]
  ],
  "lasers": [
    [0, 25, [1, 0]],
    [49, 25, [-1, 0]],
    [25, 0, [0, 1]],
    [25, 49, [0, -1]]
  ],
  "turnstiles": [
    [10, 10, [[0, -1], [1, 0], [0, 1], [-1, 0]]],
    [39, 10, [[0, -1], [1, 0], [0, 1], [-1, 0]]],
    [10, 39, [[0, -1], [1, 0], [0, 1], [-1, 0]]],
    [39, 39, [[0, -1], [1, 0], [0, 1], [-1, 0]]]
  ],
  "goal": [25, 22]
}